1111111111
10P0100001
1C00C00011
10001000E1
1111111111