1111111111
10P0100001
1C0000C011
1000C000E1
1111111111