1111111111
10P0000C01
1C0E00C001
10000000C1
1111111111