1111111111
10P0000001
1C000E0001
1000000001
1111111111