111111111111111111111111111111111
100000000000000000000000000000001
100000000000011100111110000000001
100000000000100000100010000000001
10000000000100000000E010000000001
100000000001000000000100000000001
1000C0C00001111100001000000000001
100CCCCC0001000010001000000000001
100CCCCC00000CP010001000000000001
1000CCC00001000010001000000000001
10000C000000111100001000000000001
100000000000000000000000000000001
111111111111111111111111111111111